@@@@@@@@@@@@@@@@@@@@@@@@@@@@@@@@@@@@@@@@@@@@@@@@@@@@@@@@@@@@@@@
@''''''''''''''''''@''''''''+'''''''''''''@::::::::::::::@::::@
@'''''''''@@@@@''''@''''''''''''''''''''''@::::::::::@@@@@::::@
@''@@@@@''@@@@@@@@@@''''''''''''''''''''''@::::::::@@@@@@@@@::@
@''@@@@@'''@@@@@@@@@''''''''''''''''''''''@::::::::@@@@@@@::::@
@'''@@''''''@'@@@@'@''''''''''''''''''''''@::::::::@@@@@@@@:::@
@''''@'''+''@''@'''@''''''''''''''''''''''@:::::::::::@@@:::::@
@''''@'''+''@''@'''@''''''''''''''''''''''@:::::::::::::::::::@
@''''@'''+'''''@'''@''''''''''''''''''''''@:::::::::::::::::::@
@'''''''---''''@'''@''''''''''''''''''''''@:::::::::::::::::::@
@@@@@@@@@@@@@@@@@@@@@@@@@@@@@@@@@@@@@@@@@@@@@@@@@@@@@@@@@@@@@@@
@``````````````````@::::::::::::::::::::::@;;;;;;;;;;;;;;;;;;;@
@``````````````````@:::::::::::::@@:::::::@;;;;;@@@@@;;;;;;;;;@
@``````````````````@::::::::::::@``@::::::@;;;;@@@@@@@@@@@@;;;@
@``````````````````@:::::::::::@````@:::::@;;;;@@@@@@@@@@@@;;;@
@``````````````````@::::::::::@``````@::::@;;;;@@@@@@@@@@@@;;;@
@``````````````````@::::::::::@````;;@::::@;;;;@@@@@@@@@@@@;;;@
@``````````````````@::::::::::@``::++@::::@;;;;;@@@@@@@@@@;;;;@
@``````````````````@::::::::::@``::``@::::@;;;;;;;@@@@@@@@;;;;@
@``````````````````@::::::::::@@@@@@@@::::@;;;;;;;;@@@@@@@;;;;@
@``````````````````@::::::::::::::::::::::@;;;;;;;;@@@@@@@@;;;@
@``````````````````@::::::::::::::::::::::@;;;;;;;;;@@@@@@@;;;@
@``````````````````@::::::::::::::::::::::@;;;;;;;;;;;;;;;;;;;@
@``````````````````@::::::::::::::::::::::@;;;;;;;;;;;;;;;;;;;@
@@@@@@@@@@@@@@@@@@@@@@@@@@@@@@@@@@@@@@@@@@@@@@@@@@@@@@@@@@@@@@@
@``````````````````@``````````````````````@......@@@@@@@@@@@@@@
@``````````````````@``````````````````````@.....@@@@@@@@@@@@@@@
@``````````````````@``````````````````````@.....@@@@@@@@@@@@@@@
@``````````````````@``````````````````````@......@@''''@@@@@@@@
@``````````````````@``````````````````````@........''''''@@@@@@
@``````````````````@``````````````````````@...........'''@@@@.@
@``````````````````@``````````````````````@...................@
@``````````````````@``````````````````````@...................@
@``````````````````@``````````````````````@...................@
@``````````````````@``````````````````````@...................@
@@@@@@@@@@@@@@@@@@@@@@@@@@@@@@@@@@@@@@@@@@@@@@@@@@@@@@@@@@@@@@@